Healthcare 
- Tx : Treatment การรักษา 
- I/O : Intake/Outtake ปริมาณน้ำเข้าออกในแต่ละวัน 
- aws : Alcohol Withdrawal score การประเมนิ กลมุ่ อาการจากการถอนแอลกอฮอล์ 
- pvc : Premature Ventriular Contracture หัวใจห้องล่างเต้นผิดจังหวะ 
- plan : ผลประโยชน์ของประกันสุขภาพที่คุณจ่าย
- Plan year : ปีที่ครอบคลุมในการทำประกันสุขภาพ
- Network : สิ่งอำนวยความสะดวก ผู้ให้บริการ และซัพพลายเออร์ ประกัน สุขภาพของคุณ หรือ        แผนได้ทำสัญญาเพื่อใหบริการดูแลสุขภาพบริการ 
- Lifetime limit : วงเงินที่ผู้ทำประกันสุขภาพสามารถใช้ได้ทั้งวัน 
- interest : ดอกเบี้ย
- Health coverage : ความครอบคลุมของประกันสุขภาพ 

Hotel & Lodging 
- Availability : จำนวนห้องที่เปิดขายในวันที่ที่กำหนดไว้ 
- Accommodation : หมายถึงห้อง ตึก ที่ให้บริการให้ผู้คนมาพักอาศัย
- Booking : การจองห้อง 
- Bizcation : การรวมระหว่าง Business กับ Vacation เป็นการเที่ยวพร้อมกับทำงานไปด้วย 
- Business hotel : โรงแรมที่ใหบริการลูกค้าที่พักผ่อนด้วยเหตุผลทางธุรกิจ และเป็นรายได้หลัก
- Close out : ห้องที่ไม่สามารถให้บริการด้วยเหตุผลต่าง ๆ 
- Channels : แพลตฟอร์มที่ให้ในการจองห้อง 
- Commission : ค่าใช้จ่ายที่ให้กับ Third-party เช่น นายหน้า ที่ขายห้องให้ลูกค้า
- Demand : ระดับความต้องการลูกค้า 
- Denial : การปฏิเสธการซื้อของของลูกค้า 

Transportation & Logistics 
- Axle load : น้ำหนักของเพลารถ 
- Blind shipment : พัสดุที่ไม่มีรายละเอียดผู้ส่ง 
- Bogie : กลุ่มของล้อที่ใช้ในการติดกับยานพาหนะไว้สำหรับขนส่ง
- Broker : บุคคลที่ให้เช่าอุปกรณ์ให้กับผู้ให้บริการ 
- Cargo : สิ่งที่ขนส่ง 
- Consign : การส่งสินค้าให้ผู้ซื้อหรือตัวแทนขาย 
- FIFO : สิงของที่ถูกเก็บก่อนจะถูกให้ก่อน 
- Gross weight : น้ำหนักสุทธิของพัสดุ รวมถึงบรรจุภัณฑ์
- Marking : ตัวอักษร ตัวเลขหรือสัญลักษณ์ที่ใช้ระบุตัวตน
- Net weight : น้ำหนักสุทธิของพัสดุ ไม่รวมบรรจุภัณฑ์